Level 6
42
#########
## H ####
##BBB####
#   K####
##TP  ###
##M#BB  #
##  B M##
#####LB #
##### D##
#########