Level 8
12
##D##
# M #
# M #
# M #
# M #
# M #
# M #
# M #
# M #
#   #
# H #
#####