Level 9
33
#####D#####
####   ####
####BLB####
##B#B  # ##
#B  BBB  K#
# BBB  BB #
##H B  B ##
###########